56-0x
---------------------------------------------
------------------0---0---0------------------
--------0--0------------0--------------------
-----------------0------0---0----------------
----00------0---------0------0---0----0------
---------0---------------00-----------------0
---------------------------0-----------------
--0--------------------0--0------0-----------
-----0---------------------------------0-----
------0----------0---------------------------
------------------0--0----------------------0
----------------------------------0----------
--0----------------------------------0-----0-
-----0------------------------00-------------
---------------------------------------------
----------------------------0----------------
--0------------0-----------------------------
--0-----------------------0-----0------------
0--------------------------------------------
-----------------00---------0---0-----------0
---0---------0-0-----------------------------
---------------------------0-----------------
------------------0-------0------------------
--00-0------0-0---0-----------------------0--
---------------------------------------------
----0---0------------0--0--------------------
-----------0-0------0------------------------
0-------------0----------------------0-------
---------------------------------------------
----------------------0-------------00----0--
--------0-------------0--------0-------0-----
-----------------0-------------0-------------
---------------------------------------------
---------------------------------------------
---------------------------------------------
-----------------------0---------------------
----------------------------------------0----
------------------------------------------0--
-----------------------------0----0----------
----------------00---------------------------
-0---0-------------------0------------------0
-----0-0--0-------0--0-------0---------------
---------0--0----------------------------0---
-0---------------------0----0----------------
----------------0-0--------------0-----------
--------0--------------------00------0-------
----0-0--------------------------------------
----0-----------------------0--------------0-
------------------0--------------------------
-----0-----------0---------------------0-----
---------------------------------0-----------
----0---------------------------0----------0-
--------------0-------------------0----------
-------0-----------0------------------------0
-------------------0-------------------------
---------------------------------0---0---0---
