28-0x
-0-----0-------0-----0----0--------0-0----0---0----------------0-----------0------00-0--0-00--0
0---0------0---------0-----0------------0--0---------0-----------0-0------0-0---0--------------
0----------------0-0------------0---0------0------0----0-------0--------0--------0-0-----------
---------0-0---0-------0-0-----00--00----------0-------00-0-----------000---00----------00---0-
0----0-0-------00--00--0--0----------0----0------00-----------------0-------0---------0-----00-
---------0--0---------------------00--0----0-------0-------------0----------------00---00-0----
---0------0--0-------------0---------------------------0----------------------0-----0----00---0
-0----0--0-0---------0--------0----00-----0-0---------0---0---0--0----0-----0-00----------0----
0-----------00----0-----0------0--0-0-00------0------------0----0-----00---------00-0--0--00---
0---------0---0---0-0-------0----0---0--0-----------0------------------0-----0----0------------
-00----00---00-0-00--------0----0----0--------00-0----0--0-00-0----0--------0-------------0-0--
--------------0---0-------0--0---00--0---0-0-----00------00--0---------------------------0-----
----0--------------------0--0-0---0-----00--00-----------0---0----0---------------------0----0-
--0-------0-00---------0-0---0--------00---0-0-------0---0--------------0-0-0-0----------------
-------------0-0-0--0--------0--0------0--00-----00----0-------------00-0-0----------0----0-0-0
---------0-------0----------0-----------00---------0---0--0--0---------0-0-0----0000-----0-----
-------0----------0-------0-----------0----0-------------------------0000----------00----00----
00-------0---0--00-----0----0--0--0----0-0-0--0----------------------0-----0-------------------
-------------0-------------------000-----0--00-----------0--------0--0--0-------0--0----------0
--0-0---------00-0-------0--0-0--------------0-------0--0--0----0-----0------------0------0----
-----------------------0-----------0---------0----00---0------0--------------------------------
---0-----0------------0-------00-0-0---0------0--00-00----0----0---0---00----0---------0-----0-
------------000-0---------------0--0-------00-----------00--0----------0------0-0------0-----0-
---0-----------0-0--------0000-0-0--0----0--00-----0----0-------------0---0------00--------0---
---------------0------------000-----00-----------------0----00-----0-00-----------------0--0--0
------000----00----0-0--------------00----------0-----00--000--0---0----------0--------------0-
------0-----------000-------0-0----------00------0-----0000----------------0-----------0-----00
----0-------0-0----0--------0------0------------0----0---0----0--------0----0-----0-----000----
